1111111111111111111111
1E0000000000000C000001
1010010100101000000001
10P0000000101110000011
1000000000000000000001
1111111111111111111111
